VVVVVVVVVVVVVVVVVVVVVV
VVVVVVVVVVVVVVVVVVVVVV
VVVVVVVVVVVVVVVVVVVVVV
VVVVVVVVVVVDVVVVVVVVVV
VVVVVVVVVVDDDVVVVVVVVV
VVVVVVVV4DD5DDVVVVVVVV
VVVVVV3VDDDDDDDVVVVVVV
VVVVVVVDDDDDDDDDVVVVVV
VVVVV2DDDDDDDDDDDVVVVV
VVVVVDDDDDDDDDDgDDVVVV
VVVVDDDDDDDDDDDDDDDVVV
VVVDD1DDDDDDDDDDgDDDVV
VVVVDDDDDDDDSDDDDDDVVV
VVVVVDDDDDDDDDDDYDVVVV
VVVVVVDDDDDDDDDDDVVVVV
VVVVVVVDDgDDDCDDVVVVVV
VVVVVVVVgDDDDDDVVVVVVV
VVVVVVVVVDgDDDVVVVVVVV
VVVVVVVVVVDDDVVVVVVVVV
VVVVVVVVVVVDVVVVVVVVVV
VVVVVVVVVVVVVVVVVVVVVV
VVVVVVVVVVVVVVVVVVVVVV
