VVVVVVVVVVVVVVVVVVVVVVVVVVVVVVV
VVVVVVVVVVVVVVVVVVVVVVVVVVVVVVV
VVVVVVVDDkDkDDDDVVVVVVVVVVVVVVV
VVVVVDDDqD3DDbDDDVVVVVVVVVVVVVV
VVVVVDDDD2DD4DnDDVVVVVVVVVVVVVV
VVVVDDD1qDDDD5bDDVVVVVVVVVVVVVV
VVVVDpDDDDDDDDDnDVVVVVVVVVVVVVV
VVVVDDpDDDDDDDDDDDVVVVVVVVVVVVV
VVVVDDDDDDDDgDoDDDVVVVVVVVVVVVV
VVVVDDgDDDSDDDDDDDVVVVVVVVVVVVV
VVVVDDDDDDDoDDDxDDVVVVVVVVVVVVV
VVVVDDDDDDDDDDYDDDVVVVVVVVVVVVV
VVVVDDDCxDDDDDDDoDVVVVVVVVVVVVV
VVVVDDDDDgDDDDDDDDVVVVVVVVVVVVV
VVVVVDxDDDDDDgDDDVVVVVVVVVVVVVV
VVVVVVDDDoDDDDDDVVVVVVVVVVVVVVV
VVVVVVVDDDDxDDDVVVVVVVVVVVVVVVV
VVVVVVVVDDDDDoDVVVVVVVVVVVVVVVV
VVVVVVVVDDDDDDDVVVVVVVVVVVVVVVV
VVVVVVVVVDDDxDDVVVVVVVVVVVVVVVV
VVVVVVVVVDDDDDVVVVVVVVVVVVVVVVV
VVVVVVVVVVDDDDVVVVVVVVVVVVVVVVV
VVVVVVVVVVDDDDVVVVVVVVVVVVVVVVV
VVVVVVVVVVVDDDVVVVVVVVVVVVVVVVV
VVVVVVVVVVVDDVVVVVVVVVVVVVVVVVV
