VVVVVVVVVVVVVVVVVVVVVV
VVVVVVVVVVVVVVVVVVVVVV
VVVVVVVDDDDDDDDDDVVVVV
VVVVVDDDD1DDDD5DDDVVVV
VVVVDDDDDDDDDDDDDDDVVV
VVVDDDgDDDDDDDDgDDDDVV
VVVDD2DDDDDDDDDD4DDVVV
VVVDDDDDgDDDDgDDDDDDVV
VVVDDDDDDDDDDDDDDDDDVV
VVDDDDDDDDD3DDDDDDDDVV
VVDDDDgDDDDDDDDDgDDDVV
VVDDDDDDDDSDDDDDDDDDVV
VVDDDDDDDDDDDDDDgDDDVV
VVDDDDgDDDDDDDDDDDDDVV
VVVDDDDDDDDCDDDDDDDVVV
VVVDDDDDDDDDDDDDDDDVVV
VVVVDDDDDgDDDDYDDDVVVV
VVVVVDDDDDDDDDDDDVVVVV
VVVVVVDDDDDDDDDDVVVVVV
VVVVVVVVDDDDDDVVVVVVVV
VVVVVVVVVVVVVVVVVVVVVV
VVVVVVVVVVVVVVVVVVVVVV
