VVVVVVVVVVVVVVVVVVVVVVVVVVVVVVV
VVVVVVVVVVVVVVVVVVVVVVVVVVVVVVV
VVVVVVVDDkDkDDDDVVVVVVVVVVVVVVV
VVVVVDDDqD3DDbDDDVVVVVVVVVVVVVV
VVVVVDDDD2DD4DnDDVVVVVVVVVVVVVV
VVVVDDD1qDDDD5bDDVVVVVVVVVVVVVV
VVVVDpDDDDDDDDDnDDVVVVVVVVVVVVV
VVVVDDpDDDDDDDDDDDDVVVVVVVVVVVV
VVVVDDDDDDDDgDoDDDDVVVVVVVVVVVV
VVVVDDgDDDSDDDDDDDDVVVVVVVVVVVV
VVVDDDDDDDDoDDDxDDDDVVVVVVVVVVV
VVVDDDDDDDDDDDYDDDDDVVVVVVVVVVV
VVVDDDDCxDDDDDDDoDDDVVVVVVVVVVV
VVVVDDDDDgDDDDDDDDDVVVVVVVVVVVV
VVVVVDxDDDDDDgDDDDVVVVVVVVVVVVV
VVVVVVDDDoDDDDDDDVVVVVVVVVVVVVV
VVVVVVVDDDDxDDDDVVVVVVVVVVVVVVV
VVVVVVVVDDDDDoDVVVVVVVVVVVVVVVV
VVVVVVVVVDDDDDDVVVVVVVVVVVVVVVV
VVVVVVVVVVDDxDDVVVVVVVVVVVVVVVV
VVVVVVVVVVVDDDDVVVVVVVVVVVVVVVV
VVVVVVVVVVVVDDVVVVVVVVVVVVVVVVV
VVVVVVVVVVVVVDVVVVVVVVVVVVVVVVV
VVVVVVVVVVVVVVVVVVVVVVVVVVVVVVV
VVVVVVVVVVVVVVVVVVVVVVVVVVVVVVV
