VVVVVVVVVVVVVVVVVVVVV
VVVVVVVVVVVVVVVVVVVVV
VVVVVVVDDDDDDDDVVVVVV
VVVVVVDDDD3DDDDVVVVVV
VVVVVVVDD2DD4DDVVVVVV
VVVVVVD1DDDDD5DVVVVVV
VVVVVVVDDDDDDDDVVVVVV
VVVVVVDDDDDDDDDVVVVVV
VVVVVVVDDDDDgDDVVVVVV
VVVVVVgDDDSDDDDVVVVVV
VVVVVVVDDDDDDDDVVVVVV
VVVVVVDDDDDDDDYVVVVVV
VVVVVVVCDDDDDDDVVVVVV
VVVVVVVDDgDDDDVVVVVVV
VVVVVVVVDDDDDgVVVVVVV
VVVVVVVVVDDDVVVVVVVVV
VVVVVVVVVVDDVVVVVVVVV
