VVVVVVVVVVVVVVVVVVVVVVVVVVVVVVVVVVVVVVVV
VVVVVVVVVVVVBBBBBBBBBBBBBBBBVVVVVVVVVVVV
VVVVVVVVVVVVBBByBBBBBBByBBBBVVVVVVVVVVVV
VVVVVVVVVVVVBBBBBBB1BBBBBBBBVVVVVVVVVVVV
VVVVVVVVVVVVBBBBBBBHBBBBBBBBVVVVVVVVVVVV
VVVVVVVVVVVVBfBBBBBBBBBBBBfBVVVVVVVVVVVV
VVVVVVVVVVVVBBzBBBBBBBBBzBBBVVVVVVVVVVVV
VVVVVVVVVVVVBBBBBBBBBBBBBBBBVVVVVVVVVVVV
VVVVVVVVVVVVBBBBBBBBBBBBBBBBVVVVVVVVVVVV
VVVVVVVVVVVVVVVVVVMMVVVVVVVVVVVVVVVVVVVV
VVVVVVVVVVVVVVVVVVGGVVVVVVVVVVVVVVVVVVVV
VVVVVVVVGGGGGGGGGGGGGGGGGGGGGGGGVVVVVVVV
VVVVVVVVGGGGGGGGGGGNGGGGGGGGGGGGVVVVVVVV
VVVVVVVVGGGGyGGGGGGGGGGGGGGyGGGGVVVVVVVV
VVVVVVVVGGGGGGxGGGGxGGGGxGGGGGGGVVVVVVVV
VVVVVVVVGGGGGGGGGGGGGGGGGGGGGGGGVVVVVVVV
VVVVVVVVGGGfGGGGGGGGGGGGGGGGfGGGVVVVVVVV
VVVVVVVVGGdGGGGGzGGGGGGzGGGGGdGGVVVVVVVV
VVVVVVVVGGGGGGGGGGGGGGGGGGGGGGGGVVVVVVVV
VVVVVVVVVVVVVVVVVVAAVVVVVVVVVVVVVVVVVVVV
VVVVVVVVVVVVVVVVVVPPVVVVVVVVVVVVVVVVVVVV
VVVVVVVVGGGGGGGGGGG2GGGGGGGzGGGGVVVVVVVV
VVVVVVVVGGfGGGGGGGfGGyGGGGGGGGGGVVVVVVVV
VVVVVVVVGGGGGGfGGGGGGGGGGGfGGGGGVVVVVVVV
VVVVVVVVGGGzGGGGGGGGGGfGGGGGGGGGVVVVVVVV
VVVVVVVVGGGGGGGGyGGGGGGGGGGGGfGGVVVVVVVV
VVVVVVVVGyGGdGGGGGGGGGGGzGGGGGGGVVVVVVVV
VVVVVVVVGGGGGGGGGGGGdGGGGGGGdGGGVVVVVVVV
VVVVVVVVGGGGGGGGGGGGGGGGGGGGGGGGVVVVVVVV
VVVVVVVV~~~~~~~~~~KK~~~~~~~~~~~~VVVVVVVV
VVVVVVVV~~~~~~~~~~KK~~~~~~~~~~~~VVVVVVVV
VVVVVVVVPPPPPPPPPPPPPPPPPPPPPPPPVVVVVVVV
VVVVVVVVPPPfPPPPPPPPPPPPfPPPPPdPVVVVVVVV
VVVVVVVVPPPPPPyPPPPPPPPPPPPPdPPPVVVVVVVV
VVVVVVVVPPdPPPPPPPPPPPPPPPPPPPPPVVVVVVVV
VVVVVVVVPPPPPfPPPPPPPPPPPPPfPPPPVVVVVVVV
VVVVVVVVPPPPPPPPzPPPPPPzPPPPPPPPVVVVVVVV
VVVVVVVVPzPP4PPPPPPPPPPPPPyPPPPPVVVVVVVV
VVVVVVVVPPPPPPPPPPPPCPPPPPPPPPPPVVVVVVVV
VVVVVVVVVVVVVVVVVVPSPVVVVVVVVVVVVVVVVVVV
