VVVVVVVVVVVVVVVVVVVVVVVVVVVVVVVVVVVVVVVV
VVVVVVVVVVVVVVVVBBBBBBBBVVVVVVVVVVVVVVVV
VVVVVVVVVVVVVVVVBBBBBBBBVVVVVVVVVVVVVVVV
VVVVVVVVVVVVVVVVBBBOOBBBVVVVVVVVVVVVVVVV
VVVVVVVVVVVVVVVVBBBBBBBBVVVVVVVVVVVVVVVV
VVVVVVVVVVVVVVVVBBBBBBBBVVVVVVVVVVVVVVVV
VVVVVVVVVVBBBBBBBBBBBBBBBBBBBBVVVVVVVVVV
VVVVVVVVVVBBBBBBBBBBBBBBBBBBBBVVVVVVVVVV
VVVVVVVVVVBBBBBNBBB1BBBBBBBBBBVVVVVVVVVV
VVVVVVVVVVBBBBBBBBBBBBqBBBBBBBVVVVVVVVVV
VVVVVVVVVVBBeBBBBBBBBBBBBBBeBBVVVVVVVVVV
VVVVVVVVVVBBBBBBBBBBBBBBBBBBBBVVVVVVVVVV
VVVVVVVVVVBBBBBBBBBeBBBBBBBBBBVVVVVVVVVV
VVVVVVVVVVBjBBBBBBBBBBBBBBBBjBVVVVVVVVVV
VVVVVVVVVVBBBBqBBBBBBBBBBqBBBBVVVVVVVVVV
VVVVVVVVVVBBBBBBBBBBBBBBBBBBBBVVVVVVVVVV
VVVVVVVVVVBBBBBBBBBBBBBBBBBBBBVVVVVVVVVV
VVVVVVVVVVVVVVVVVVHHVVVVVVVVVVVVVVVVVVVV
VVVVVVVVVVVVVVVVVVGGVVVVVVVVVVVVVVVVVVVV
VVVVVVVVVVVVVVVVVVGGVVVVVVVVVVVVVVVVVVVV
VVVVVVVVGGGGGGGGGGGGGGGGGGGGGGGGVVVVVVVV
VVVVVVVVGGGGGGGGGGG2GGGGGGGGGGGGVVVVVVVV
VVVVVVVVGGjGEGGGGGGGGGGGGGG3GGGGVVVVVVVV
VVVVVVVVGGGGGGeGGGGGGGGGGGjGGGGGVVVVVVVV
VVVVVVVVGGGeGGGGGGGGGGqGGGGGGGGGVVVVVVVV
VVVVVVVVGGGGGGGGjGGGGGGGGGGGGeGGVVVVVVVV
VVVVVVVVGGGGqGGGGGGGGGGGqGGGGGGGVVVVVVVV
VVVVVVVVGeGGGGGGGGGGjGGGGGGGqGGGVVVVVVVV
VVVVVVVVGGGGGGGGGGGGGGGGGGGGGGGGVVVVVVVV
VVVVVVVV~~~~~~~~~~LL~~~~~~~~~~~~VVVVVVVV
VVVVVVVV~~~~~~~~~~PP~~~~~~~~~~~~VVVVVVVV
VVVVVVVVPPPPPPPPPPPPPPPPPPPPPPPPVVVVVVVV
VVVVVVVVPPPjPPPPPPPPPPPPjPPPPPPPVVVVVVVV
VVVVVVVVPPPPPPqPPPPPPPPPPPPPePPPVVVVVVVV
VVVVVVVVPPePPPPPPPPPPPPPPPPPPPePVVVVVVVV
VVVVVVVVPPPPPqPPPPPPPPPPPPPqPPPPVVVVVVVV
VVVVVVVVPPPPPPPPjPPPPPPqPPPPPPPPVVVVVVVV
VVVVVVVVPPPP4PPPPPPPPPPPPPjPPPPPVVVVVVVV
VVVVVVVVPPPPPPPPPPPPCPPPPPPPPPPPVVVVVVVV
VVVVVVVVVVVVVVVVVVPSPVVVVVVVVVVVVVVVVVVV
