VVVVVVVVVVVVVVOOOOOOOOOOOOVVVVVVVVVVVVVV
VVVVVVVVVVVVVOOOOOOOOOOOOOOVVVVVVVVVVVVV
VVVVVVVVVVVVVOOOOO1OOOOOOOOVVVVVVVVVVVVV
VVVVVVVVVVVVVOOOOOOOOOOOOOOVVVVVVVVVVVVV
VVVVVVVVVVVVMMMMMMMMMMMMMMMMVVVVVVVVVVVV
VVVVVVVVVVVVMTMMMMKKMMMMMTMMVVVVVVVVVVVV
VVVVVVVVVVVVMMMMMM//MMMMMMMMVVVVVVVVVVVV
VVVVVVVVVVVVVVVVVVDDVVVVVVVVVVVVVVVVVVVV
VVVVVVVVVVGGGGGGGGGGGGGGGGGGGGVVVVVVVVVV
VVVVVVVVVVGmGGGeGGGGGGGGGGGmGGVVVVVVVVVV
VVVVVVVVVVGGGTGGFGGGGGGGGTGGGGVVVVVVVVVV
VVVVVVVVVVGGGGGGGGG3GGGGGGGGGGVVVVVVVVVV
VVVVVVVVVVGmGGRGGGGGGGRGGGmGGGVVVVVVVVVV
VVVVVVVVVVGGGGGGGGG//GGGGGGGGGVVVVVVVVVV
VVVVVVVVVVVVVVVVVVNNVVVVVVVVVVVVVVVVVVVV
VVVVVVVVVVGGGGGGGGNNGGGGGGGGGGVVVVVVVVVV
VVVVVVVVVGGGGFGGGGNNGGGGsGGGGGGVVVVVVVVV
VVVVVVVVVGGNNGGGGGGGGGGGGGNNGGGVVVVVVVVV
VVVVVVVVVGGNNGGGGRGGGGGGGGNNGGGVVVVVVVVV
VVVVVVVVVGGGGGGGGGGG2GGGGGGGGGGVVVVVVVVV
VVVVVVVVVGAAAAGGGGGGGGGGGGAAAAGVVVVVVVVV
VVVVVVVVVGAAAAGGGRGGGsGGGGAAAAGVVVVVVVVV
VVVVVVVVVGGGGGGGGGGGGGGGGGGGGGGVVVVVVVVV
VVVVVVVVVVVVVVVVVVBBVVVVVVVVVVVVVVVVVVVV
VVVVVVVVWWWWWWWWWWBBWWWWWWWWWWWWVVVVVVVV
VVVVVVVVWWWWWWWWWWBBWWWWWWWWWWWWVVVVVVVV
VVVVVVVVWWWWWWWWWWBBWWWWWWWWWWWWVVVVVVVV
VVVVVVVVVVVVVVVVVVBBVVVVVVVVVVVVVVVVVVVV
VVVVVVVVGGGGGGGGGGKKGGGGGGGGGGGGVVVVVVVV
VVVVVVVVCCCCCCCCCCCCCCCCCCCCCCCCCVVVVVVV
VVVVVVVVCcccccRccccccscccccccccCCVVVVVVV
VVVVVVVVCccccccccccF4cccccccccccCVVVVVVV
VVVVVVVVCccRccccccScccGeGGGGcccCCVVVVVVV
VVVVVVVVCcccccCccGGGGGGGGGGGcccCCVVVVVVV
VVVVVVVVGGGGGGGGGGGGGGGGGGGGGGGGGVVVVVVV
VVVVVVVVGGRGmGsGGGFGGGGGGRGGGsGGVVVVVVVV
VVVVVVVVGGGGGGGGGGGGGGGGGGGGGGGGGVVVVVVV
VVVVVVVVGGGGGGGGFGGGGRGGGGmGGGGGVVVVVVVV
VVVVVVVVGGGGGGGGGGGGGmGGGGGGGGGGGVVVVVVV
VVVVVVVVVVVVVVVVVVVVVVVVVVVVVVVVVVVVVVVV
