0000000000000022222222222200000000000000
0000000000000222222222222220000000000000
0000000000000222220222222220000000000000
0000000000000222222222222220000000000000
0000000000001111111111111111000000000000
0000000000001011110011111011000000000000
000000000000111111//11111111000000000000
0000000000000000000000000000000000000000
0000000000111111111111111111110000000000
0000000000101110111111111110110000000000
0000000000111011011111111011110000000000
0000000000111111111011111111110000000000
0000000000101101111111011101110000000000
0000000000111111111//1111111110000000000
0000000000000000000000000000000000000000
0000000000000000000000000000000000000000
0000000000000000000000000000000000000000
0000000000000000000000000000000000000000
0000000000000000000000000000000000000000
0000000000000000000000000000000000000000
0000000000000000000000000000000000000000
0000000000000000000000000000000000000000
0000000000000000000000000000000000000000
0000000000000000000000000000000000000000
0000000000000000000000000000000000000000
0000000000000000000000000000000000000000
0000000000000000000000000000000000000000
0000000000000000000000000000000000000000
0000000000000000000000000000000000000000
0000000000000000000000000000000000000000
0000000000000000000000000000000000000000
0000000000000000000000000000000000000000
0000000000000000000000000000000000000000
0000000000000000000000000000000000000000
0000000000000000000000000000000000000000
0000000000000000000000000000000000000000
0000000000000000000000000000000000000000
0000000000000000000000000000000000000000
0000000000000000000000000000000000000000
0000000000000000000000000000000000000000
