VVVVVVVVVVVVVVVVVVVVVVVVVVVVVVVVVVVVVVVV
VVVVVVVVVVVVBBBoBBBBBBBoBBBBVVVVVVVVVVVV
VVVVVVVVVVVVBBBBBBB1OBBBBBBBVVVVVVVVVVVV
VVVVVVVVVVVVBhBBBBBHBBBBBBhBVVVVVVVVVVVV
VVVVVVVVVVVVBBkBBBBBBBBBkBBBVVVVVVVVVVVV
VVVVVVVVVVVVBBBBBBBBBBBBBBBBVVVVVVVVVVVV
VVVVVVVVVVVVVVVVVVMMVVVVVVVVVVVVVVVVVVVV
VVVVVVVVVVVVVVVVVVGGVVVVVVVVVVVVVVVVVVVV
VVVVVVVVVVVVVVVVVVGGVVVVVVVVVVVVVVVVVVVV
VVVVVVVVGGGGGGGGGGGGGGGGGGGGGGGGVVVVVVVV
VVVVVVVVGGGGGGGGGGGNGGGGGGGGGGGGVVVVVVVV
VVVVVVVVGGGGoGGGGGGGGGGGGGGoGGGGVVVVVVVV
VVVVVVVVGGGGGGxGGGGxGGGGxGGGGGGGVVVVVVVV
VVVVVVVVGGGGGGGGGGGGGGGGGGGGGGGGVVVVVVVV
VVVVVVVVGGGhGGGGGGGGGGGGGGGGhGGGVVVVVVVV
VVVVVVVVGGkGGGGGbGGGGGGbGGGGGkGGVVVVVVVV
VVVVVVVVGGGGGGGGGGGGGGGGGGGGGGGGVVVVVVVV
VVVVVVVVVVVVVVVVVVDDVVVVVVVVVVVVVVVVVVVV
VVVVVVVVVVVVVVVVVVGGVVVVVVVVVVVVVVVVVVVV
VVVVVVVVVVVVVVVVVVGGVVVVVVVVVVVVVVVVVVVV
VVVVVVVVGGGGGGGGGGGGGGGGGGGGGGGGVVVVVVVV
VVVVVVVVGGGGGGGGGGG2GGGGGGGGGGGGVVVVVVVV
VVVVVVVVGGhGEGGGGGGGGGGGGGG3GGGGVVVVVVVV
VVVVVVVVGGGGGGkGGGGGGGGGGGhGGGGGVVVVVVVV
VVVVVVVVGGGbGGGGGGGGGGoGGGGGGGGGVVVVVVVV
VVVVVVVVGGGGGGGGoGGGGGGGGGGGGkGGVVVVVVVV
VVVVVVVVGGGGbGGGGGGGGGGGkGGGGGGGVVVVVVVV
VVVVVVVVGbGGGGGGGGGGhGGGGGGGoGGGVVVVVVVV
VVVVVVVVGGGGGGGGGGGGGGGGGGGGGGGGVVVVVVVV
VVVVVVVV~~~~~~~~~~KK~~~~~~~~~~~~VVVVVVVV
VVVVVVVV~~~~~~~~~~PP~~~~~~~~~~~~VVVVVVVV
VVVVVVVVPPPPPPPPPPPPPPPPPPPPPPPPVVVVVVVV
VVVVVVVVPPPhPPPPPPPPPPPPhPPPPPPPVVVVVVVV
VVVVVVVVPPPPPPkPPPPPPPPPPPPPoPPPVVVVVVVV
VVVVVVVVPPoPPPPPPPPPPPPPPPPPPPoPVVVVVVVV
VVVVVVVVPPPPPkPPPPPPPPPPPPPkPPPPVVVVVVVV
VVVVVVVVPPPPPPPPbPPPPPPbPPPPPPPPVVVVVVVV
VVVVVVVVPPPP4PPPPPPPPPPPPPhPPPPPVVVVVVVV
VVVVVVVVPPPPPPPPPPPPPPPPPPPPPPPPVVVVVVVV
VVVVVVVVVVVVVVVVVVPSPVVVVVVVVVVVVVVVVVVV
