VVVVVVVVVVVVVOOOOOOOOOOOOOOVVVVVVVVVVVVV
VVVVVVVVVVVVVOOOOOOOOOOOOOOVVVVVVVVVVVVV
VVVVVVVVVVVVVOOOOO1KOOOOOOOVVVVVVVVVVVVV
VVVVVVVVVVVVVOOOOO//OOOOOOOVVVVVVVVVVVVV
VVVVVVVVVVVVVVVVVVHHVVVVVVVVVVVVVVVVVVVV
VVVVVVVVVVVVVVVVVVHHVVVVVVVVVVVVVVVVVVVV
VVVVVVVVVVVVMMMMMtMMfMtMMMMMVVVVVVVVVVVV
VVVVVVVVVVVVMMtMMMMfMMMMMtMMVVVVVVVVVVVV
VVVVVVVVVVVVMbMMMMMMMMMMMMbMVVVVVVVVVVVV
VVVVVVVVVVVVMMMMMM//MMMMMMMMVVVVVVVVVVVV
VVVVVVVVVVVVVVVVVVLLVVVVVVVVVVVVVVVVVVVV
VVVVVVVVVVVVVVVVVCLLVV3VVVVVVVVVVVVVVVVV
VVVVVVVVGGGGGGGGGGGGGGGGGGGGGGGGVVVVVVVV
VVVVVVVVGGGGGbGGGGGGGGGGGGbGGGGGVVVVVVVV
VVVVVVVVGGGGGGGGGrGGGGrGGGGGGGGGVVVVVVVV
VVVVVVVVGGGlGGGGGGGGGGGGGGGGlGGGVVVVVVVV
VVVVVVVVGGGGrGGGGGGGGGGGGGGrGGGGVVVVVVVV
VVVVVVVVGGGGGGlGGGGGGGGGGlGGGGGGVVVVVVVV
VVVVVVVVGGGGGGGGGGGGGGGGGGGGGGGGVVVVVVVV
VVVVVVVVVVVVVVVVVEvvVV2VVVVVVVVVVVVVVVVV
VVVVVVVVVVVVVVVVVVvvVVVVVVVVVVVVVVVVVVVV
VVVVVVVVGGGGGGGGGGGGGGGGGGGGGGGGVVVVVVVV
VVVVVVVVGGGGlGGGGkGGGGkGGGGlGGGGVVVVVVVV
VVVVVVVVGGwGGGGGGGGGGGGGGGGGGwGGVVVVVVVV
VVVVVVVVGGGkGGGGGGGGGGGGGGGGkGGGVVVVVVVV
VVVVVVVVGGGGGwGGGGGGGGGGGGwGGGGGVVVVVVVV
VVVVVVVVGGGGGGGGlGGGGGGlGGGGGGGGVVVVVVVV
VVVVVVVVGGGGGGkGGGGGGGGGGkGGGGGGVVVVVVVV
VVVVVVVVGGGGGGGGGGXGGGGGGGGGGGGGVVVVVVVV
VVVVVVVVVVVVVVVVVVggVVVVVVVVVVVVVVVVVVVV
VVVVVVVVVVVVVVVVVVggVVVVVVVVVVVVVVVVVVVV
VVVVVVVVBBBBBBBBBBBBBBBBBBBBBBBBVVVVVVVV
VVVVVVVVBBBtBBBBBBBBBBBBBBBBtBBBVVVVVVVV
VVVVVVVVBBBBBBrBBBBBBBBBrBBBBBBBVVVVVVVV
VVVVVVVVBBbBBBBBBBBBBBBBBBBBBBbBVVVVVVVV
VVVVVVVVppppptpppppppppppptpppppVVVVVVVV
VVVVVVVVBBBrBBBBBfBBBBfBBBBrBBBBVVVVVVVV
VVVVVVVVBBBBBBBbBBBSBB4BbBBBBBBBVVVVVVVV
VVVVVVVVBBrBBfBBBBBBBBBBBBfBBrBBVVVVVVVV
VVVVVVVVVVVVVVVVVVVVVVVVVVVVVVVVVVVVVVVV
