VVVVVVVVVVVVVOOOOOOOOOOOOOOVVVVVVVVVVVVV
VVVVVVVVVVVVVOOOOOO1OOOOOOOVVVVVVVVVVVVV
VVVVVVVVVVVVVOOOOOOOOOOOOOOVVVVVVVVVVVVV
VVVVVVVVVVVVVOOOOO//OOOOOOOVVVVVVVVVVVVV
VVVVVVVVVVVVVVVVVVHHVVVVVVVVVVVVVVVVVVVV
VVVVVVVVVVVVVVVVVV//VVVVVVVVVVVVVVVVVVVV
VVVVVVVVMMMMMMMMMMMMMMMMMMMMMMMMVVVVVVVV
VVVVVVVVMMMMMqdMMMMMMMMMMdqMMMMMVVVVVVVV
VVVVVVVVMMMMMMMMmMMdMMMmMMMMMMMMVVVVVVVV
VVVVVVVVMMMMMMMMMMMMMMMMMMMMMMMMVVVVVVVV
VVVVVVVVVVVVVVVVVVLLVVVVVVVVVVVVVVVVVVVV
VVVVVVVVVVVVVVVVVCLLV3VVVVVVVVVVVVVVVVVV
VVVVVVVVMMMMMMMMMMMoMMMMMMMMMMMMVVVVVVVV
VVVVVVVVMMMMzMMMMMMMMMMMMMMzMMMMVVVVVVVV
VVVVVVVVMMMMMMmMMMMMMMMMMmMMMMMMVVVVVVVV
VVVVVVVVMMMxMMMMMMMMMMMMMMMMxMMMVVVVVVVV
VVVVVVVVMMMMMoMMMMMmMMMMMMoMMMMMVVVVVVVV
VVVVVVVVMMMMMMMzMMMoMMMMzMMMMMMMVVVVVVVV
VVVVVVVVMMMMMMMMMM//MMMMMMMMMMMMVVVVVVVV
VVVVVVVVVVVVVVVVVEvvV2VVVVVVVVVVVVVVVVVV
VVVVVVVVVVVVVVVVVVvvVVVVVVVVVVVVVVVVVVVV
VVVVVVVVRRRRRRRRRRRmRRRRRRRRRRRRVVVVVVVV
VVVVVVVVRRRRqRRRRRRRRRRRRRRqRRRRVVVVVVVV
VVVVVVVVRRRRRRmRRRRRRRRRRmRRRRRRVVVVVVVV
VVVVVVVVRRRRxRRRRRRRRRRRRRRxRRRRVVVVVVVV
VVVVVVVVRRRRRRRRsRRRRRRsRRRRRRRRVVVVVVVV
VVVVVVVVRRRmRRRRRRRqRRRRRRRRmRRRVVVVVVVV
VVVVVVVVRRRRRRRRRRRRRRRRRRRRRRRRVVVVVVVV
VVVVVVVVRRRRRRRRRRRmRRRRRRRRRRRRVVVVVVVV
VVVVVVVVVVVVVVVVVVggVVVVVVVVVVVVVVVVVVVV
VVVVVVVVVVVVVVVVVVggVVVVVVVVVVVVVVVVVVVV
VVVVVVVVAAAAAAAAAAAAAAAAAAAAAAAAVVVVVVVV
VVVVVVVVAAAqAsdAAAAAAAAAAdsAqAAAVVVVVVVV
VVVVVVVVAAAAAAAqAAAAAAAAqAAAAAAAVVVVVVVV
VVVVVVVVAAAAAAxAAAdAAdAAAxAAAAAAVVVVVVVV
VVVVVVVVAAsAAAAAAAAAAAAAAAAAAsAAVVVVVVVV
VVVVVVVVAAAAqAAAyAAAAAAyAAAAAAAAVVVVVVVV
VVVVVVVVAAAAAAAAAAASA4AAAAAAAAAAVVVVVVVV
VVVVVVVVAAAyAAAAAAAqAAAAAAAAyAAAVVVVVVVV
VVVVVVVVVVVVVVVVVVVVVVVVVVVVVVVVVVVVVVVV
