VVVVVVVVVVVVVVVVVVVVVVVVVVVVVVVVVVVVVVVV
VVVVVVVVVVVVOOOcOOOOOOOcOOOOVVVVVVVVVVVV
VVVVVVVVVVVVOOOOOOO1oOOOOOOOVVVVVVVVVVVV
VVVVVVVVVVVVOqOOOOOHOOOOOOqOVVVVVVVVVVVV
VVVVVVVVVVVVOOrOOO//OOOOrOOOVVVVVVVVVVVV
VVVVVVVVVVVVOOOOOOOOOOOOOOOOVVVVVVVVVVVV
VVVVVVVVVVVVVVVVVVLLVVVVVVVVVVVVVVVVVVVV
VVVVVVVVVVVVVVVVVVMMVVVVVVVVVVVVVVVVVVVV
VVVVVVVVVVVVVVVVVVMMVVVVVVVVVVVVVVVVVVVV
VVVVVVVVMMMMMMMMMMMMMMMMMMMMMMMMVVVVVVVV
VVVVVVVVMMMMMMMMMMMNMMMMMMMMMMMMVVVVVVVV
VVVVVVVVMMMMcMMMMMMMM5MMMMMcMMMMVVVVVVVV
VVVVVVVVMMMMMMzMMMMzMMMMzMMMMMMMVVVVVVVV
VVVVVVVVMMMMMxMMMMMMMMMMMMxMMMMMVVVVVVVV
VVVVVVVVMMMqMMMMMMMMMMMMMMMMqMMMVVVVVVVV
VVVVVVVVMMrMMMMMiMMMMMMiMMMMMrMMVVVVVVVV
VVVVVVVVMMMMMMMMMMMMMMMMMMMMMMMMVVVVVVVV
VVVVVVVVVVVVVVVVVVvvVVVVVVVVVVVVVVVVVVVV
VVVVVVVVVVVVVVVVVV//VVVVVVVVVVVVVVVVVVVV
VVVVVVVVVVVVVVVVVEMMVVVVVVVVVVVVVVVVVVVV
VVVVVVVVMMMMMMMMMMMMMMMMMMMMMMMMVVVVVVVV
VVVVVVVVMMMMMMMMMMM2MMMMMMMMMMMMVVVVVVVV
VVVVVVVVMMqMWMMMMMMMMMMMMMM3MMMMVVVVVVVV
VVVVVVVVMMMMMMrMMMMMMMMMMMqMMMMMVVVVVVVV
VVVVVVVVMMMiMMMMMMMMMMcMMMMMMMMMVVVVVVVV
VVVVVVVVMMMMMMMxcMMMMMMxMMMMMrMMVVVVVVVV
VVVVVVVVMMMMiMMMMMMMMMMMrMMMMMMMVVVVVVVV
VVVVVVVVMiMMMMMMMMMMqMMMMMMMcMMMVVVVVVVV
VVVVVVVVMMMMMMMMMMMMMMMMMMMMMMMMVVVVVVVV
VVVVVVVVVVVVVVVVVVggVVVVVVVVVVVVVVVVVVVV
VVVVVVVVVVVVVVVVVVggVVVVVVVVVVVVVVVVVVVV
VVVVVVVVAAAAAAAAAXAAAAAAAAAAAAAAVVVVVVVV
VVVVVVVVAAAqAAAAAAAAAAAAqAAAAAAAVVVVVVVV
VVVVVVVVAAAAAArAAAAAAAAAAAAAcAAAVVVVVVVV
VVVVVVVVAAcAAAAAAAAAAAAAAAAAAAcAVVVVVVVV
VVVVVVVVAAAAArAAAAAAAAAAAAArAAAAVVVVVVVV
VVVVVVVVAqAAAAAAiAAAAAAiAAAAAAAAVVVVVVVV
VVVVVVVVAAAA4AAAAAAAAAAAAAqAAAAAVVVVVVVV
VVVVVVVVAAAAAAAAAAAACAAAAAAAAAAAVVVVVVVV
VVVVVVVVVVVVVVVVVVASAVVVVVVVVVVVVVVVVVVV
