0000000000000222222222222220000000000000
0000000000000222222222222220000000000000
0000000000000222222222222220000000000000
000000000000022222//22222220000000000000
0000000000000000002200000000000000000000
000000000000000000//00000000000000000000
0000000011111111111111111111111100000000
0000000011111111111111111111111100000000
0000000011111111111111111111111100000000
0000000011111111111111111111111100000000
0000000000000000000000000000000000000000
0000000000000000000000000000000000000000
0000000011111111111111111111111100000000
0000000011111111111111111111111100000000
0000000011111111111111111111111100000000
0000000011111111111111111111111100000000
0000000011111111111111111111111100000000
0000000011111111111111111111111100000000
000000001111111111//11111111111100000000
0000000000000000000000000000000000000000
0000000000000000000000000000000000000000
0000000000000000000000000000000000000000
0000000000000000000000000000000000000000
0000000000000000000000000000000000000000
0000000000000000000000000000000000000000
0000000000000000000000000000000000000000
0000000000000000000000000000000000000000
0000000000000000000000000000000000000000
0000000000000000000000000000000000000000
0000000000000000000000000000000000000000
0000000000000000000000000000000000000000
0000000000000000000000000000000000000000
0000000000000000000000000000000000000000
0000000000000000000000000000000000000000
0000000000000000000000000000000000000000
0000000000000000000000000000000000000000
0000000000000000000000000000000000000000
0000000000000000000000000000000000000000
0000000000000000000000000000000000000000
0000000000000000000000000000000000000000
