VVVVVVVVVVVVVOOOOOOOOOOOOOOVVVVVVVVVVVVV
VVVVVVVVVVVVVOOOOOO1OOOOOOOVVVVVVVVVVVVV
VVVVVVVVVVVVVOOkOOOOOOOOkOOVVVVVVVVVVVVV
VVVVVVVVVVVVVOOOOO//OOOOOOOVVVVVVVVVVVVV
VVVVVVVVVVVVVVVVVVHHVVVVVVVVVVVVVVVVVVVV
VVVVVVVVVVVVVVVVVV//VVVVVVVVVVVVVVVVVVVV
VVVVVVVVCCCCCCCCCCkCCCCCCCCCCCCCVVVVVVVV
VVVVVVVVCCCrCkCCCCCCCCCCCCCCrCCCVVVVVVVV
VVVVVVVVCCCCCCCCCCCCCCkCrCCCCCCCVVVVVVVV
VVVVVVVVCCCCCCCCCCCCCCCCkCCCCCCCVVVVVVVV
VVVVVVVVVVVVVVVVVVYYVVVVVVVVVVVVVVVVVVVV
VVVVVVVVVVVVVVVVVVYYV3VVVVVVVVVVVVVVVVVV
VVVVVVVVQQQQQnQQQWQQQQQQQQQQQQQQVVVVVVVV
VVVVVVVVQQQQAQQpQQQQQQQQQQQBQQQQVVVVVVVV
VVVVVVVVQQbnQQwQQpQQQQQQQQQQQQQQVVVVVVVV
VVVVVVVVQQQQQQQQQQQQQQQQpQQQQbQQVVVVVVVV
VVVVVVVVQQQQQQQQQQQQpQQQQQbQQQQQVVVVVVVV
VVVVVVVVQQQQQbQQQQQQQQQQwQQQQnQQVVVVVVVV
VVVVVVVVQQQQQQQQQQ//QQQQQQQQQQQQVVVVVVVV
VVVVVVVVVVVVVVVVVEeeVVVVVVVVVVVVVVVVVVVV
VVVVVVVVVVVVVVVVVVeeVVVVVVVVVVVVVVVVVVVV
VVVVVVVVLLLLLLLLLLL2LLLLLLLLLLLLVVVVVVVV
VVVVVVVVLLLLLwLnLLLLLLhLLLLLLLLLVVVVVVVV
VVVVVVVVLLLpLLLhLLLLwLLLLLLLLLLLVVVVVVVV
VVVVVVVVLLLLhLLLLpLLLLLLLLLLLLLLVVVVVVVV
VVVVVVVVLLLLLLLLLLLLLLLLpLLhLLLLVVVVVVVV
VVVVVVVVLLLLLLLLwLLLLLLLLLLLLpLLVVVVVVVV
VVVVVVVVLLLLLLLLLLLLLLLLLLwLLLLLVVVVVVVV
VVVVVVVVLLLLLLLLLLLLLLLLLLLLLLLLVVVVVVVV
VVVVVVVVVVVVVVVVVVggVVVVVVVVVVVVVVVVVVVV
VVVVVVVVVVVVVVVVVVggVVVVVVVVVVVVVVVVVVVV
VVVVVVVVPPPPPPPPPXPPPPPPPPPPPPPPVVVVVVVV
VVVVVVVVPPPPPrPPPPPnPPPPPPbPPPPPVVVVVVVV
VVVVVVVVPPPkPPPhPbPPPPPPPPPPPPPPVVVVVVVV
VVVVVVVVPPrPPnPPPPPPhPPPPPPPPPPPVVVVVVVV
VVVVVVVVPPPhPPPPPPPPPPPPPPPPrPPPVVVVVVVV
VVVVVVVVPPPPnPbPPPPPPPPPhPPPkPPPVVVVVVVV
VVVVVVVVPPPPPPPPPPPSP4PPPPPnPPPPVVVVVVVV
VVVVVVVVPPPPPPPPbPPPkPrPPPPPPPPPVVVVVVVV
VVVVVVVVVVVVVVVVVVVVVVVVVVVVVVVVVVVVVVVV
