VVVVVVVVVVVVVVVVVVVVVVVVVVVVVVVVVVVVVVVV
VVVVVVVVVVVVbOOzOOumOtOzuOOOVVVVVVVVVVVV
VVVVVVVVVVVVOuOOOOb1oOmOOtOOVVVVVVVVVVVV
VVVVVVVVVVVVOsOOOOpHbuOOOusOVVVVVVVVVVVV
VVVVVVVVVVVVOOjOOO//OmOujOOOVVVVVVVVVVVV
VVVVVVVVVVVVOmOOmOOOOuOuOtbOVVVVVVVVVVVV
VVVVVVVVVVVVVVVVVVLLVVVVVVVVVVVVVVVVVVVV
VVVVVVVVVVVVVVVVVVCCVVVVVVVVVVVVVVVVVVVV
VVVVVVVVVVVVVVVVVVCCVVVVVVVVVVVVVVVVVVVV
VVVVVVVVCCbCCCCCCbCtCCCCCfCCCpCCVVVVVVVV
VVVVVVVVCtCCCCCCmuCNCCCCfCCuCuCCVVVVVVVV
VVVVVVVVCCCpzCCCCCbCt5CfCCCzbbCCVVVVVVVV
VVVVVVVVCCCmCCyCtCuyCCfCyCtuCbCCVVVVVVVV
VVVVVVVVCCbuCxtbbCCCCfCCCCxCpCCCVVVVVVVV
VVVVVVVVfCCsmCpmCCCCfCCCCCmbsCCCVVVVVVVV
VVVVVVVVCfjCuCCCdCCfCCCdupCmbjCfVVVVVVVV
VVVVVVVVCCfCCmmmCCfCCbCCCCCCCCfCVVVVVVVV
VVVVVVVVVVVVVVVVVVeeVVVVVVVVVVVVVVVVVVVV
VVVVVVVVVVVVVVVVVV//VVVVVVVVVVVVVVVVVVVV
VVVVVVVVVVVVVVVVVEQQVVVVVVVVVVVVVVVVVVVV
VVVVVVVVQuQQQQfQQubQQQQQQQfQQQQQVVVVVVVV
VVVVVVVVQQmQQfQfQQQ2uQQQQfQQpQpQVVVVVVVV
VVVVVVVVQpsQFQQQfQQQpQQQfQQ3tQQQVVVVVVVV
VVVVVVVVQQQfQQjQQfQQQQQfQQsQQmQQVVVVVVVV
VVVVVVVVQQfdQmQQQQfQQQzQQtuQQQuQVVVVVVVV
VVVVVVVVQfQQbbbxzQQfQfQxuuutQjQQVVVVVVVV
VVVVVVVVfQQQdbQmQQQQfQQQjQQbQtQQVVVVVVVV
VVVVVVVVQdQQbQQbQQQfsfQQQQubzpmQVVVVVVVV
VVVVVVVVQuQbbpQQQQfQQQfQQQtuQQmQVVVVVVVV
VVVVVVVVVVVVVVVVVVggVVVVVVVVVVVVVVVVVVVV
VVVVVVVVVVVVVVVVVVggVVVVVVVVVVVVVVVVVVVV
VVVVVVVVAAAAAAAfAXAbAmAAAfAAAbuAVVVVVVVV
VVVVVVVVAAAsAAfAAAbAmAAAsAfAAAAAVVVVVVVV
VVVVVVVVAmpAAfjAAAAAAuAApAAfzAAAVVVVVVVV
VVVVVVVVAuzAfAAAbAAAAmbAAAAAfAzAVVVVVVVV
VVVVVVVVAAAfAjAmAmAmtAAAAmpjAfAAVVVVVVVV
VVVVVVVVAsfAAAuudAmAAbAdAmAAAAfAVVVVVVVV
VVVVVVVVAfAA4AAAAAAmAAmbAAsbAAAfVVVVVVVV
VVVVVVVVfAAAAuptbAAbCAmtAAptAAAAVVVVVVVV
VVVVVVVVVVVVVVVVVVASuVVVVVVVVVVVVVVVVVVV
