0000000000000000000000000000000000000000
0000000000002220222222202222000000000000
0000000000002222222222222222000000000000
0000000000002022222222222202000000000000
000000000000220222//22220222000000000000
0000000000002222222222222222000000000000
0000000000000000000000000000000000000000
0000000000000000000000000000000000000000
0000000000000000001100000000000000000000
0000000011111111111111111111111100000000
0000000011111111111111111111111100000000
0000000011111111111111111111111100000000
0000000011111111111111111111111100000000
0000000011111111111111111111111100000000
0000000011111111111111111111111100000000
0000000011111111111111111111111100000000
0000000011111111111111111111111100000000
0000000000000000000000000000000000000000
000000000000000000//00000000000000000000
0000000000000000011100000000000000000000
0000000011111111111111111111111100000000
0000000011111111111111111111111100000000
0000000011111111111111111111111100000000
0000000011111111111111111111111100000000
0000000011111111111111111111111100000000
0000000011111111111111111111111100000000
0000000011111111111111111111111100000000
0000000011111111111111111111111100000000
0000000011111111111111111111111100000000
0000000000000000000000000000000000000000
0000000000000000000000000000000000000000
0000000000000000000000000000000000000000
0000000000000000000000000000000000000000
0000000000000000000000000000000000000000
0000000000000000000000000000000000000000
0000000000000000000000000000000000000000
0000000000000000000000000000000000000000
0000000000000000000000000000000000000000
0000000000000000000000000000000000000000
0000000000000000000000000000000000000000
