VVVVVVVVVVVVVVVVVVVVVVVVVVVVVVVVVVVVVVVV
VVVVVVVVVVVVOOOzOOOOOOOzOOOOVVVVVVVVVVVV
VVVVVVVVVVVVOOOOOOO1oOOOOOOOVVVVVVVVVVVV
VVVVVVVVVVVVOsOOOOOHOOOOOOsOVVVVVVVVVVVV
VVVVVVVVVVVVOOjOOO//OOOOjOOOVVVVVVVVVVVV
VVVVVVVVVVVVOOOOOOOOOOOOOOOOVVVVVVVVVVVV
VVVVVVVVVVVVVVVVVVLLVVVVVVVVVVVVVVVVVVVV
VVVVVVVVVVVVVVVVVVCCVVVVVVVVVVVVVVVVVVVV
VVVVVVVVVVVVVVVVVVCCVVVVVVVVVVVVVVVVVVVV
VVVVVVVVCCCCCCCCCCCCCCCCCCCCCCCCVVVVVVVV
VVVVVVVVCCCCCCCCCCCNCCCCCCCCCCCCVVVVVVVV
VVVVVVVVCCCCzCCCCCCCC5CCCCCzCCCCVVVVVVVV
VVVVVVVVCCCCCCyCCCCyCCCCyCCCCCCCVVVVVVVV
VVVVVVVVCCCCCxCCCCCCCCCCCCxCCCCCVVVVVVVV
VVVVVVVVCCCsCCCCCCCCCCCCCCCCsCCCVVVVVVVV
VVVVVVVVCCjCCCCCdCCCCCCdCCCCCjCCVVVVVVVV
VVVVVVVVCCCCCCCCCCCCCCCCCCCCCCCCVVVVVVVV
VVVVVVVVVVVVVVVVVVeeVVVVVVVVVVVVVVVVVVVV
VVVVVVVVVVVVVVVVVV//VVVVVVVVVVVVVVVVVVVV
VVVVVVVVVVVVVVVVVEQQVVVVVVVVVVVVVVVVVVVV
VVVVVVVVQQQQQQQQQQQQQQQQQQQQQQQQVVVVVVVV
VVVVVVVVQQQQQQQQQQQ2QQQQQQQQQQQQVVVVVVVV
VVVVVVVVQQsQFQQQQQQQQQQQQQQ3QQQQVVVVVVVV
VVVVVVVVQQQQQQjQQQQQQQQQQQsQQQQQVVVVVVVV
VVVVVVVVQQQdQQQQQQQQQQzQQQQQQQQQVVVVVVVV
VVVVVVVVQQQQQQQxzQQQQQQxQQQQQjQQVVVVVVVV
VVVVVVVVQQQQdQQQQQQQQQQQjQQQQQQQVVVVVVVV
VVVVVVVVQdQQQQQQQQQQsQQQQQQQzQQQVVVVVVVV
VVVVVVVVQQQQQQQQQQQQQQQQQQQQQQQQVVVVVVVV
VVVVVVVVVVVVVVVVVVggVVVVVVVVVVVVVVVVVVVV
VVVVVVVVVVVVVVVVVVggVVVVVVVVVVVVVVVVVVVV
VVVVVVVVAAAAAAAAAXAAAAAAAAAAAAAAVVVVVVVV
VVVVVVVVAAAsAAAAAAAAAAAAsAAAAAAAVVVVVVVV
VVVVVVVVAAAAAAjAAAAAAAAAAAAAzAAAVVVVVVVV
VVVVVVVVAAzAAAAAAAAAAAAAAAAAAAzAVVVVVVVV
VVVVVVVVAAAAAjAAAAAAAAAAAAAjAAAAVVVVVVVV
VVVVVVVVAsAAAAAAdAAAAAAdAAAAAAAAVVVVVVVV
VVVVVVVVAAAA4AAAAAAAAAAAAAsAAAAAVVVVVVVV
VVVVVVVVAAAAAAAAAAAACAAAAAAAAAAAVVVVVVVV
VVVVVVVVVVVVVVVVVVASAVVVVVVVVVVVVVVVVVVV
