VVVVVVVVVVVVGGGGmmmmmmmmGGGGVVVVVVVVVVVV
VVVVVVVVVVVVGGGGmmmmmmmmGGGGVVVVVVVVVVVV
VVVVVVVVVVVVGGGGGGGOOGGGGGGGVVVVVVVVVVVV
VVVVVVVVVVVVGGGGGGGOOGGGGGGGVVVVVVVVVVVV
VVVVVVVVVVVVTGGGGGGGGGGGGGGTVVVVVVVVVVVV
VVVVVVVVVVVVGTGGGGGGGGGGGGTGVVVVVVVVVVVV
VVVVVVVVVVVVGGTGGGGGGGGGGTGGVVVVVVVVVVVV
VVVVVVVVVVVVVVVVVVVNNVVVVVVVVVVVVVVVVVVV
VVVVVVVVVVGGGGGGGGGGGGGGGGGGGGVVVVVVVVVV
VVVVVVVVVVGGGGGGTGGGGGGTGGGGGGVVVVVVVVVV
VVVVVVVVVVGGGGTGGFGGGGFGGTGGGGVVVVVVVVVV
VVVVVVVVVVGGGTGGGGG3GGGGGGTGGGVVVVVVVVVV
VVVVVVVVVVGGTGGFGGGFGGGGFGGTGGVVVVVVVVVV
VVVVVVVVVVGTGGGGFGGGFGFGGGGGTGVVVVVVVVVV
VVVVVVVVVVVVTVVVVVFVVFVVVVVTVVVVVVVVVVVV
VVVVVVVVVVVVVVVVVVgVVVVVVVVVVVVVVVVVVVVV
VVVVVVVVVVVVVVVVVVBVVVVVVVVVVVVVVVVVVVVV
VVVVgggggggggggggggggggggggggggVVVVVVVVV
VVVVggggggggRggggggsgggggFgggggVVVVVVVVV
VVVVgggggFgggggTgggggsggggRggggVVVVVVVVV
VVVVgggggggFggggFgg2ggRggggTgggVVVVVVVVV
VVVVggTggggggsggggggggggFggggggVVVVVVVVV
VVVVgggFggRgggFgggggTgggggFggggVVVVVVVVV
VVVGggggggggggggggFggggggggggggVVVVVVVVV
VVVWWWWWWWWWWWWWKWWWWWWWWWWWWWWVVVVVVVVV
VVVWwwwwwwwwwwwwKwwwwwwwwwwwwwWVVVVVVVVV
VVVWWWWWWWWWWWWWKWWWWWWWWWWWWWWVVVVVVVVV
VVVGGGGGGGGGGGGGGGGGGGGGGGGGGGGVVVVVVVVV
VVVGGGGGGGGGGGMMGGGGGGGGGGGGGGGGVVVVVVVV
VVVGGGGGRGGGGGGGGGRGGGGGGGGGGGGVVVVVVVVV
VVVGGGGGGG4GGGGGDDDDDGFGGsGGGGGVVVVVVVVV
VVVGGGGGGTGGGGG4DDDDDGGFGGsGGGGVVVVVVVVV
VVVGGGGGGGGGSCGGGGGGGGGGGGGGGGGVVVVVVVVV
VVVGWWWWWWWWUGGGGGGGGGGGGGGGGGGVVVVVVVVV
VVVGWwwwwwWWGGGGGGGGGGGGGGGGGGGVVVVVVVVV
VVVGWwwwwwWWGGFGGGGGGGGGGGGGGGGVVVVVVVVV
VVVGWwwwwwWWGGGGTGGGGGGGGGGGGGGVVVVVVVVV
VVVGWwwwwwWWGGGGGGGGGGRGGGGGGGGVVVVVVVVV
VVVGWWWWWWWWGGTGGGGGFGGGGGGGGGGVVVVVVVVV
VVVGGGGGGGGGGGGGGGGGGGGGGGGGGGGVVVVVVVVV
